cheval	ʃə.val	horse	m
tu	ty	you	
manger	mɑ̃.ʒe	to eat	
un	ɛ̃	a (m)	
croissant	kʁwa.sɑ̃	croissant 	m
une	yn	a (f)	
fille	fij	girl	f
et	e	and	
orange	ɔ.ʁɑ̃ʒ	orange 	f
chat	ʃa	cat	m
femme	fam	woman	f
être 	ɛtʁ	to be	
chien	ʃjɛ̃	dog	m
le	lə	the (m)	
la	la	the (f)	
les	le	the (pl)	
homme	ɔm	man	m
garçon	ɡaʁ.sɔ̃	boy	
pizza	pid.za	pizza	f
hamburger	ɑ̃.bœʁ.ɡœʁ, ɑ̃.buʁ.ɡɛʁ		m
je	ʒə	I 	
oui	wi	yes	
bonjour 	bɔ̃.ʒuʁ	hello	
ça va 	sa va	(it goes)	
bien	bjɛ̃	good	
comment 	kɔ.mɑ̃		
merci	mɛʁ.si	thanks	
salut	sa.ly	hi	
toi	twa	you (d.o.)	
bonsoir	bɔ̃.swaʁ	good evening	
très	tʁɛ	very 	
enchanté	ɑ̃.ʃɑ̃.te	nice to meet you 	
moi	mwa	me	
au revoir	o ʁə.vwaʁ	goodbye	
bienvenue	bjɛ̃.v(ə).ny	welcome 	
à bientôt	a bjɛ̃.to	see you soon 	
bonne journée	bɔn ʒuʁ.ne	have a nice day	
à demain	a d(ə).mɛ̃	see you tomorrow 	
bonne nuit	bɔn nɥi	good night 	
bonne soirée	bɔn swa.ʁe	good evening 	
beaucoup	bo.ku	a lot	